,Unnamed: 0,Unnamed: 0.1,episode_reward,nb_episode_steps,nb_steps
0,0.0,0.0,190.0,595,595
1,1.0,1.0,255.0,1225,1820
2,2.0,2.0,260.0,640,2460
3,3.0,3.0,290.0,656,3116
4,4.0,4.0,245.0,613,3729
5,5.0,5.0,225.0,635,4364
6,6.0,6.0,270.0,726,5090
7,7.0,7.0,215.0,605,5695
8,8.0,8.0,280.0,719,6414
9,9.0,9.0,270.0,715,7129
10,10.0,10.0,235.0,607,7736
11,11.0,11.0,270.0,722,8458
12,12.0,12.0,280.0,731,9189
13,13.0,13.0,270.0,712,9901
14,14.0,14.0,245.0,623,10524
15,15.0,15.0,220.0,775,11299
16,16.0,16.0,435.0,1051,12350
17,17.0,17.0,360.0,1175,13525
18,18.0,18.0,230.0,607,14132
19,19.0,19.0,210.0,647,14779
20,20.0,20.0,485.0,929,15708
21,21.0,21.0,270.0,859,16567
22,22.0,22.0,495.0,858,17425
23,23.0,23.0,195.0,645,18070
24,24.0,24.0,205.0,635,18705
25,25.0,25.0,150.0,647,19352
26,26.0,26.0,170.0,1254,20606
27,27.0,27.0,410.0,948,21554
28,28.0,28.0,295.0,871,22425
29,29.0,29.0,215.0,798,23223
30,30.0,30.0,220.0,1174,24397
31,31.0,31.0,460.0,1099,25496
32,32.0,32.0,35.0,490,25986
33,33.0,33.0,630.0,1127,27113
34,34.0,34.0,170.0,639,27752
35,35.0,35.0,285.0,778,28530
36,36.0,36.0,190.0,684,29214
37,37.0,37.0,320.0,738,29952
38,38.0,38.0,190.0,643,30595
39,39.0,39.0,250.0,647,31242
40,40.0,40.0,165.0,1132,32374
41,41.0,41.0,190.0,1102,33476
42,42.0,42.0,305.0,823,34299
43,43.0,43.0,310.0,898,35197
44,44.0,44.0,475.0,1064,36261
45,45.0,45.0,320.0,992,37253
46,46.0,46.0,100.0,511,37764
47,47.0,47.0,95.0,521,38285
48,48.0,48.0,155.0,633,38918
49,49.0,49.0,155.0,671,39589
50,50.0,50.0,250.0,853,40442
51,51.0,51.0,440.0,1108,41550
52,52.0,52.0,180.0,591,42141
53,53.0,53.0,595.0,1118,43259
54,54.0,54.0,180.0,588,43847
55,55.0,55.0,205.0,663,44510
56,56.0,56.0,335.0,1185,45695
57,57.0,57.0,285.0,840,46535
58,58.0,58.0,375.0,708,47243
59,59.0,59.0,320.0,946,48189
60,60.0,60.0,300.0,1405,49594
61,61.0,61.0,410.0,1113,50707
62,62.0,62.0,305.0,1090,51797
63,63.0,63.0,145.0,771,52568
64,64.0,64.0,430.0,1149,53717
65,65.0,65.0,230.0,807,54524
66,66.0,66.0,115.0,640,55164
67,67.0,67.0,400.0,1268,56432
68,68.0,68.0,115.0,407,56839
69,69.0,69.0,200.0,893,57732
70,70.0,70.0,510.0,1209,58941
71,71.0,71.0,295.0,888,59829
72,72.0,72.0,420.0,1161,60990
73,73.0,73.0,125.0,537,61527
74,74.0,74.0,20.0,655,62182
75,75.0,75.0,5.0,959,63141
76,76.0,76.0,90.0,617,63758
77,77.0,77.0,130.0,348,64106
78,78.0,78.0,195.0,546,64652
79,79.0,79.0,10.0,650,65302
80,80.0,80.0,110.0,930,66232
81,81.0,81.0,30.0,661,66893
82,82.0,82.0,320.0,867,67760
83,83.0,83.0,145.0,1027,68787
84,84.0,84.0,180.0,611,69398
85,85.0,85.0,185.0,777,70175
86,86.0,86.0,165.0,664,70839
87,87.0,87.0,340.0,822,71661
88,88.0,88.0,420.0,1523,73184
89,89.0,89.0,215.0,997,74181
90,90.0,90.0,545.0,977,75158
91,91.0,91.0,235.0,762,75920
92,92.0,92.0,405.0,1020,76940
93,93.0,93.0,565.0,1380,78320
94,94.0,94.0,200.0,797,79117
95,95.0,95.0,270.0,1052,80169
96,96.0,96.0,220.0,1030,81199
97,97.0,97.0,165.0,891,82090
98,98.0,98.0,95.0,366,82456
99,99.0,99.0,165.0,681,83137
100,100.0,100.0,670.0,1223,84360
101,101.0,101.0,130.0,478,84838
102,102.0,102.0,280.0,891,85729
103,103.0,103.0,40.0,680,86409
104,104.0,104.0,115.0,690,87099
105,105.0,105.0,115.0,648,87747
106,106.0,106.0,365.0,1298,89045
107,107.0,107.0,85.0,663,89708
108,108.0,108.0,135.0,703,90411
109,109.0,109.0,175.0,532,90943
110,110.0,110.0,130.0,958,91901
111,111.0,111.0,235.0,667,92568
112,112.0,112.0,605.0,1492,94060
113,113.0,113.0,380.0,1119,95179
114,114.0,114.0,410.0,1376,96555
115,115.0,115.0,245.0,1189,97744
116,116.0,116.0,420.0,835,98579
117,117.0,117.0,145.0,670,99249
118,118.0,118.0,265.0,810,100059
119,119.0,119.0,205.0,1130,101189
120,120.0,120.0,435.0,1189,102378
121,121.0,121.0,385.0,1033,103411
122,122.0,122.0,60.0,440,103851
123,123.0,123.0,155.0,1251,105102
124,124.0,124.0,80.0,369,105471
125,125.0,125.0,85.0,357,105828
126,126.0,126.0,265.0,934,106762
127,127.0,127.0,110.0,503,107265
128,128.0,128.0,500.0,1031,108296
129,129.0,129.0,270.0,863,109159
130,130.0,130.0,195.0,685,109844
131,131.0,131.0,330.0,695,110539
132,132.0,132.0,130.0,654,111193
133,133.0,133.0,325.0,948,112141
134,134.0,134.0,110.0,741,112882
135,135.0,135.0,170.0,672,113554
136,136.0,136.0,220.0,909,114463
137,137.0,137.0,600.0,1356,115819
138,138.0,138.0,145.0,703,116522
139,139.0,139.0,240.0,578,117100
140,140.0,140.0,80.0,920,118020
141,141.0,141.0,100.0,715,118735
142,142.0,142.0,45.0,539,119274
143,143.0,143.0,215.0,769,120043
144,144.0,144.0,140.0,472,120515
145,145.0,145.0,110.0,513,121028
146,146.0,146.0,200.0,662,121690
147,147.0,147.0,260.0,1128,122818
148,148.0,148.0,115.0,601,123419
149,149.0,149.0,235.0,627,124046
150,150.0,150.0,480.0,1009,125055
151,151.0,151.0,200.0,940,125995
152,152.0,152.0,150.0,512,126507
153,153.0,153.0,435.0,1112,127619
154,154.0,154.0,230.0,953,128572
155,155.0,155.0,615.0,1083,129655
156,156.0,156.0,435.0,1197,130852
157,157.0,157.0,215.0,663,131515
158,158.0,158.0,675.0,1277,132792
159,159.0,159.0,110.0,691,133483
160,160.0,160.0,255.0,756,134239
161,161.0,161.0,155.0,621,134860
162,162.0,162.0,215.0,891,135751
163,163.0,163.0,95.0,521,136272
164,164.0,164.0,395.0,1127,137399
165,165.0,165.0,320.0,1179,138578
166,166.0,166.0,465.0,1319,139897
167,167.0,167.0,165.0,734,140631
168,168.0,168.0,95.0,632,141263
169,169.0,169.0,485.0,1100,142363
170,170.0,170.0,250.0,762,143125
171,171.0,171.0,490.0,1069,144194
172,172.0,172.0,215.0,813,145007
173,173.0,173.0,175.0,719,145726
174,174.0,174.0,205.0,1067,146793
175,175.0,175.0,185.0,615,147408
176,176.0,176.0,115.0,541,147949
177,177.0,177.0,490.0,965,148914
178,178.0,178.0,215.0,823,149737
179,179.0,179.0,60.0,335,150072
180,180.0,180.0,180.0,707,150779
181,181.0,181.0,105.0,465,151244
182,182.0,182.0,35.0,397,151641
183,183.0,183.0,25.0,507,152148
184,184.0,184.0,290.0,992,153140
185,185.0,185.0,60.0,477,153617
186,186.0,186.0,215.0,829,154446
187,187.0,187.0,235.0,841,155287
188,188.0,188.0,410.0,1212,156499
189,189.0,189.0,500.0,1041,157540
190,190.0,190.0,85.0,638,158178
191,191.0,191.0,405.0,1063,159241
192,192.0,192.0,160.0,658,159899
193,193.0,193.0,440.0,1338,161237
194,194.0,194.0,335.0,1226,162463
195,195.0,195.0,85.0,557,163020
196,196.0,196.0,510.0,1533,164553
197,197.0,197.0,210.0,850,165403
198,198.0,198.0,15.0,396,165799
199,199.0,199.0,190.0,861,166660
200,200.0,200.0,235.0,925,167585
201,201.0,201.0,185.0,828,168413
202,202.0,202.0,255.0,855,169268
203,203.0,203.0,415.0,1420,170688
204,204.0,204.0,195.0,644,171332
205,205.0,205.0,235.0,1036,172368
206,206.0,206.0,395.0,1453,173821
207,207.0,207.0,170.0,715,174536
208,208.0,208.0,460.0,1306,175842
209,209.0,209.0,200.0,985,176827
210,210.0,210.0,150.0,648,177475
211,211.0,211.0,210.0,665,178140
212,212.0,212.0,375.0,1387,179527
213,213.0,213.0,105.0,1253,180780
214,214.0,214.0,210.0,927,181707
215,215.0,215.0,105.0,482,182189
216,216.0,216.0,75.0,377,182566
217,217.0,217.0,150.0,630,183196
218,218.0,218.0,135.0,632,183828
219,219.0,219.0,190.0,676,184504
220,220.0,220.0,55.0,683,185187
221,221.0,221.0,315.0,825,186012
222,222.0,222.0,15.0,717,186729
223,223.0,223.0,110.0,772,187501
224,224.0,224.0,320.0,673,188174
225,225.0,225.0,55.0,659,188833
226,226.0,226.0,0.0,360,189193
227,227.0,227.0,105.0,995,190188
228,228.0,228.0,455.0,1247,191435
229,229.0,229.0,130.0,660,192095
230,230.0,230.0,195.0,807,192902
231,231.0,231.0,125.0,661,193563
232,232.0,232.0,130.0,541,194104
233,233.0,233.0,80.0,746,194850
234,234.0,234.0,290.0,1181,196031
235,235.0,235.0,100.0,419,196450
236,236.0,236.0,240.0,1738,198188
237,237.0,237.0,115.0,518,198706
238,238.0,238.0,190.0,953,199659
239,239.0,239.0,405.0,1231,200890
240,240.0,240.0,180.0,680,201570
241,241.0,241.0,365.0,967,202537
242,242.0,242.0,615.0,1093,203630
243,243.0,243.0,305.0,1073,204703
244,244.0,244.0,250.0,750,205453
245,245.0,245.0,230.0,633,206086
246,246.0,246.0,260.0,1386,207472
247,247.0,247.0,200.0,649,208121
248,248.0,248.0,205.0,1200,209321
249,249.0,249.0,0.0,423,209744
250,250.0,250.0,180.0,828,210572
251,251.0,251.0,300.0,1164,211736
252,252.0,252.0,5.0,1206,212942
253,253.0,253.0,10.0,837,213779
254,254.0,254.0,145.0,642,214421
255,255.0,255.0,120.0,704,215125
256,256.0,256.0,105.0,434,215559
257,257.0,257.0,420.0,1667,217226
258,258.0,258.0,105.0,674,217900
259,259.0,259.0,275.0,938,218838
260,260.0,260.0,245.0,856,219694
261,261.0,261.0,105.0,367,220061
262,262.0,262.0,295.0,1081,221142
263,263.0,263.0,325.0,1096,222238
264,264.0,264.0,305.0,1067,223305
265,265.0,265.0,655.0,1772,225077
266,266.0,266.0,360.0,1608,226685
267,267.0,267.0,520.0,1010,227695
268,268.0,268.0,205.0,816,228511
269,269.0,269.0,260.0,900,229411
270,270.0,270.0,105.0,1084,230495
271,271.0,271.0,400.0,1042,231537
272,272.0,272.0,95.0,382,231919
273,273.0,273.0,465.0,942,232861
274,274.0,274.0,285.0,1073,233934
275,275.0,275.0,50.0,356,234290
276,276.0,276.0,95.0,669,234959
277,277.0,277.0,780.0,1801,236760
278,278.0,278.0,260.0,949,237709
279,279.0,279.0,255.0,937,238646
280,280.0,280.0,360.0,918,239564
281,281.0,281.0,210.0,551,240115
282,282.0,282.0,85.0,673,240788
283,283.0,283.0,340.0,1215,242003
284,284.0,284.0,315.0,943,242946
285,285.0,285.0,130.0,961,243907
286,286.0,286.0,410.0,947,244854
287,287.0,287.0,155.0,1196,246050
288,288.0,288.0,225.0,1140,247190
289,289.0,289.0,40.0,391,247581
290,290.0,290.0,170.0,507,248088
291,291.0,291.0,200.0,681,248769
292,292.0,292.0,105.0,489,249258
293,293.0,293.0,105.0,898,250156
294,294.0,294.0,605.0,1821,251977
295,295.0,295.0,275.0,1207,253184
296,296.0,296.0,280.0,795,253979
297,297.0,297.0,110.0,695,254674
298,298.0,298.0,110.0,649,255323
299,299.0,299.0,160.0,691,256014
300,300.0,300.0,190.0,510,256524
301,301.0,301.0,175.0,541,257065
302,302.0,302.0,290.0,653,257718
303,303.0,303.0,195.0,676,258394
304,304.0,304.0,515.0,1044,259438
305,305.0,305.0,165.0,530,259968
306,306.0,306.0,185.0,1145,261113
307,307.0,307.0,120.0,687,261800
308,308.0,308.0,255.0,838,262638
309,309.0,309.0,205.0,812,263450
310,310.0,310.0,185.0,805,264255
311,311.0,311.0,180.0,803,265058
312,312.0,312.0,520.0,1179,266237
313,313.0,313.0,150.0,696,266933
314,314.0,314.0,135.0,842,267775
315,315.0,315.0,345.0,981,268756
316,316.0,316.0,375.0,1189,269945
317,317.0,317.0,450.0,1613,271558
318,318.0,318.0,245.0,1243,272801
319,319.0,319.0,120.0,608,273409
320,320.0,320.0,235.0,1034,274443
321,321.0,321.0,325.0,921,275364
322,322.0,322.0,415.0,1073,276437
323,323.0,323.0,715.0,1515,277952
324,324.0,324.0,400.0,820,278772
325,325.0,325.0,140.0,493,279265
326,326.0,326.0,200.0,1074,280339
327,327.0,327.0,335.0,1067,281406
328,328.0,328.0,225.0,935,282341
329,329.0,329.0,110.0,539,282880
330,330.0,330.0,575.0,1580,284460
331,331.0,331.0,335.0,1156,285616
332,332.0,332.0,580.0,1329,286945
333,333.0,333.0,225.0,1030,287975
334,334.0,334.0,565.0,929,288904
335,335.0,335.0,85.0,632,289536
336,336.0,336.0,330.0,1332,290868
337,337.0,337.0,80.0,368,291236
338,338.0,338.0,125.0,832,292068
339,339.0,339.0,155.0,697,292765
340,340.0,340.0,175.0,634,293399
341,341.0,341.0,205.0,632,294031
342,342.0,342.0,160.0,854,294885
343,343.0,343.0,135.0,873,295758
344,344.0,344.0,320.0,941,296699
345,345.0,345.0,125.0,692,297391
346,346.0,346.0,410.0,831,298222
347,347.0,347.0,295.0,808,299030
348,348.0,348.0,245.0,1085,300115
349,349.0,349.0,200.0,855,300970
350,350.0,350.0,185.0,675,301645
351,351.0,351.0,150.0,637,302282
352,352.0,352.0,110.0,675,302957
353,353.0,353.0,175.0,644,303601
354,354.0,354.0,360.0,1225,304826
355,355.0,355.0,140.0,626,305452
356,356.0,356.0,35.0,935,306387
357,357.0,357.0,155.0,840,307227
358,358.0,358.0,370.0,1169,308396
359,359.0,359.0,130.0,690,309086
360,360.0,360.0,145.0,369,309455
361,361.0,361.0,180.0,669,310124
362,362.0,362.0,50.0,548,310672
363,363.0,363.0,145.0,605,311277
364,364.0,364.0,320.0,1102,312379
365,365.0,365.0,145.0,785,313164
366,366.0,366.0,105.0,400,313564
367,367.0,367.0,535.0,1198,314762
368,368.0,368.0,90.0,650,315412
369,369.0,369.0,105.0,491,315903
370,370.0,370.0,110.0,362,316265
371,371.0,371.0,110.0,937,317202
372,372.0,372.0,140.0,897,318099
373,373.0,373.0,160.0,683,318782
374,374.0,374.0,105.0,551,319333
375,375.0,375.0,225.0,761,320094
376,376.0,376.0,120.0,526,320620
377,377.0,377.0,145.0,630,321250
378,378.0,378.0,295.0,989,322239
379,379.0,379.0,155.0,576,322815
380,380.0,380.0,30.0,573,323388
381,381.0,381.0,245.0,726,324114
382,382.0,382.0,185.0,659,324773
383,383.0,383.0,240.0,694,325467
384,384.0,384.0,235.0,808,326275
385,385.0,385.0,540.0,1574,327849
386,386.0,386.0,520.0,1009,328858
387,387.0,387.0,335.0,1215,330073
388,388.0,388.0,105.0,663,330736
389,389.0,389.0,310.0,646,331382
390,390.0,390.0,540.0,1016,332398
391,391.0,391.0,145.0,636,333034
392,392.0,392.0,165.0,937,333971
393,393.0,393.0,355.0,874,334845
394,394.0,394.0,300.0,1478,336323
395,395.0,395.0,80.0,401,336724
396,396.0,396.0,225.0,891,337615
397,397.0,397.0,265.0,1019,338634
398,398.0,398.0,470.0,990,339624
399,399.0,399.0,215.0,896,340520
400,400.0,400.0,50.0,338,340858
401,401.0,401.0,280.0,949,341807
402,402.0,402.0,295.0,900,342707
403,403.0,403.0,55.0,445,343152
404,404.0,404.0,105.0,475,343627
405,405.0,405.0,260.0,893,344520
406,406.0,406.0,270.0,915,345435
407,407.0,407.0,480.0,1165,346600
408,408.0,408.0,230.0,715,347315
409,409.0,409.0,325.0,1176,348491
410,410.0,410.0,110.0,653,349144
411,411.0,411.0,125.0,439,349583
412,412.0,412.0,315.0,822,350405
413,413.0,413.0,540.0,1249,351654
414,414.0,414.0,240.0,731,352385
415,415.0,415.0,150.0,950,353335
416,416.0,416.0,405.0,1280,354615
417,417.0,417.0,235.0,857,355472
418,418.0,418.0,330.0,1158,356630
419,419.0,419.0,70.0,664,357294
420,420.0,420.0,105.0,655,357949
421,421.0,421.0,150.0,687,358636
422,422.0,422.0,595.0,1426,360062
423,423.0,423.0,230.0,901,360963
424,424.0,424.0,155.0,794,361757
425,425.0,425.0,110.0,641,362398
426,426.0,426.0,95.0,367,362765
427,427.0,427.0,255.0,731,363496
428,428.0,428.0,135.0,736,364232
429,429.0,429.0,195.0,836,365068
430,430.0,430.0,210.0,943,366011
431,431.0,431.0,250.0,864,366875
432,432.0,432.0,420.0,1128,368003
433,433.0,433.0,285.0,902,368905
434,434.0,434.0,50.0,392,369297
435,435.0,435.0,115.0,626,369923
436,436.0,436.0,355.0,939,370862
437,437.0,437.0,225.0,947,371809
438,438.0,438.0,195.0,645,372454
439,439.0,439.0,380.0,1084,373538
440,440.0,440.0,220.0,716,374254
441,441.0,441.0,250.0,860,375114
442,442.0,442.0,160.0,876,375990
443,443.0,443.0,165.0,643,376633
444,444.0,444.0,450.0,953,377586
445,445.0,445.0,200.0,920,378506
446,446.0,446.0,235.0,787,379293
447,447.0,447.0,245.0,903,380196
448,448.0,448.0,425.0,1292,381488
449,449.0,449.0,100.0,469,381957
450,450.0,450.0,120.0,857,382814
451,451.0,451.0,525.0,987,383801
452,452.0,452.0,215.0,651,384452
453,453.0,453.0,105.0,649,385101
454,454.0,454.0,155.0,632,385733
455,455.0,455.0,200.0,867,386600
456,456.0,456.0,150.0,856,387456
457,457.0,457.0,340.0,735,388191
458,458.0,458.0,390.0,1261,389452
459,459.0,459.0,25.0,579,390031
460,460.0,460.0,405.0,993,391024
461,461.0,461.0,425.0,1406,392430
462,462.0,462.0,175.0,685,393115
463,463.0,463.0,430.0,1066,394181
464,464.0,464.0,105.0,620,394801
465,465.0,465.0,25.0,376,395177
466,466.0,466.0,635.0,1094,396271
467,467.0,467.0,185.0,815,397086
468,468.0,468.0,240.0,893,397979
469,469.0,469.0,370.0,950,398929
470,470.0,470.0,140.0,729,399658
471,471.0,471.0,130.0,538,400196
472,472.0,472.0,160.0,602,400798
473,473.0,473.0,140.0,610,401408
474,474.0,474.0,150.0,655,402063
475,475.0,475.0,170.0,672,402735
476,476.0,476.0,155.0,727,403462
477,477.0,477.0,100.0,559,404021
478,478.0,478.0,180.0,1152,405173
479,479.0,479.0,220.0,808,405981
480,480.0,480.0,190.0,968,406949
481,481.0,481.0,290.0,966,407915
482,482.0,482.0,155.0,704,408619
483,483.0,483.0,405.0,1345,409964
484,484.0,484.0,50.0,648,410612
485,485.0,485.0,370.0,1064,411676
486,486.0,486.0,230.0,711,412387
487,487.0,487.0,300.0,843,413230
488,488.0,488.0,85.0,378,413608
489,489.0,489.0,105.0,521,414129
490,490.0,490.0,200.0,775,414904
491,491.0,491.0,285.0,801,415705
492,492.0,492.0,0.0,510,416215
493,493.0,493.0,140.0,1206,417421
494,494.0,494.0,85.0,859,418280
495,495.0,495.0,125.0,671,418951
496,496.0,496.0,675.0,1127,420078
497,497.0,497.0,195.0,904,420982
498,498.0,498.0,190.0,662,421644
499,499.0,499.0,235.0,847,422491
500,500.0,500.0,270.0,930,423421
501,501.0,501.0,390.0,1215,424636
502,502.0,502.0,135.0,929,425565
503,503.0,503.0,360.0,805,426370
504,504.0,504.0,195.0,884,427254
505,505.0,505.0,125.0,637,427891
506,506.0,506.0,50.0,523,428414
507,507.0,507.0,140.0,667,429081
508,508.0,508.0,75.0,423,429504
509,509.0,509.0,775.0,1721,431225
510,510.0,510.0,230.0,838,432063
511,511.0,511.0,10.0,533,432596
512,512.0,512.0,95.0,1270,433866
513,513.0,513.0,115.0,869,434735
514,514.0,514.0,485.0,1066,435801
515,515.0,515.0,350.0,1093,436894
516,516.0,516.0,30.0,917,437811
517,517.0,517.0,105.0,465,438276
518,518.0,518.0,60.0,427,438703
519,519.0,519.0,300.0,979,439682
520,520.0,520.0,70.0,591,440273
521,521.0,521.0,215.0,633,440906
522,522.0,522.0,310.0,868,441774
523,523.0,523.0,170.0,655,442429
524,524.0,524.0,215.0,856,443285
525,525.0,525.0,320.0,1018,444303
526,526.0,526.0,110.0,665,444968
527,527.0,527.0,600.0,1249,446217
528,528.0,528.0,160.0,670,446887
529,529.0,529.0,165.0,633,447520
530,530.0,530.0,195.0,642,448162
531,531.0,531.0,85.0,338,448500
532,532.0,532.0,85.0,680,449180
533,533.0,533.0,135.0,707,449887
534,534.0,534.0,45.0,507,450394
535,535.0,535.0,180.0,649,451043
536,536.0,536.0,215.0,795,451838
537,537.0,537.0,250.0,786,452624
538,538.0,538.0,355.0,968,453592
539,539.0,539.0,140.0,955,454547
540,540.0,540.0,20.0,524,455071
541,541.0,541.0,105.0,758,455829
542,542.0,542.0,310.0,940,456769
543,543.0,543.0,95.0,357,457126
544,544.0,544.0,450.0,1219,458345
545,545.0,545.0,90.0,461,458806
546,546.0,546.0,120.0,871,459677
547,547.0,547.0,235.0,848,460525
548,548.0,548.0,405.0,942,461467
549,549.0,549.0,140.0,813,462280
550,550.0,550.0,155.0,743,463023
551,551.0,551.0,75.0,538,463561
552,552.0,552.0,230.0,686,464247
553,553.0,553.0,240.0,790,465037
554,554.0,554.0,50.0,669,465706
555,555.0,555.0,90.0,486,466192
556,556.0,556.0,105.0,509,466701
557,557.0,557.0,35.0,660,467361
558,558.0,558.0,450.0,1068,468429
559,559.0,559.0,75.0,479,468908
560,560.0,560.0,400.0,1411,470319
561,561.0,561.0,195.0,977,471296
562,562.0,562.0,170.0,830,472126
563,563.0,563.0,180.0,697,472823
564,564.0,564.0,85.0,937,473760
565,565.0,565.0,365.0,1094,474854
566,566.0,566.0,235.0,984,475838
567,567.0,567.0,285.0,832,476670
568,568.0,568.0,35.0,387,477057
569,569.0,569.0,290.0,819,477876
570,570.0,570.0,195.0,899,478775
571,571.0,571.0,215.0,728,479503
572,572.0,572.0,200.0,507,480010
573,573.0,573.0,130.0,767,480777
574,574.0,574.0,430.0,1099,481876
575,575.0,575.0,365.0,1198,483074
576,576.0,576.0,220.0,880,483954
577,577.0,577.0,140.0,660,484614
578,578.0,578.0,205.0,1154,485768
579,579.0,579.0,330.0,997,486765
580,580.0,580.0,125.0,542,487307
581,581.0,581.0,290.0,957,488264
582,582.0,582.0,420.0,1053,489317
583,583.0,583.0,105.0,659,489976
584,584.0,584.0,55.0,632,490608
585,585.0,585.0,95.0,632,491240
586,586.0,586.0,530.0,1595,492835
587,587.0,587.0,145.0,815,493650
588,588.0,588.0,570.0,1365,495015
589,589.0,589.0,350.0,1065,496080
590,590.0,590.0,145.0,637,496717
591,591.0,591.0,255.0,774,497491
592,592.0,592.0,270.0,920,498411
593,593.0,593.0,115.0,391,498802
594,594.0,594.0,275.0,1108,499910
595,595.0,595.0,115.0,621,500531
596,596.0,596.0,410.0,950,501481
597,597.0,597.0,180.0,922,502403
598,598.0,598.0,580.0,1650,504053
599,599.0,599.0,125.0,379,504432
600,600.0,600.0,450.0,880,505312
601,601.0,601.0,60.0,720,506032
602,602.0,602.0,135.0,596,506628
603,603.0,603.0,205.0,1062,507690
604,604.0,604.0,155.0,644,508334
605,605.0,605.0,105.0,494,508828
606,606.0,606.0,155.0,513,509341
607,607.0,607.0,450.0,1570,510911
608,608.0,608.0,305.0,1038,511949
609,609.0,609.0,225.0,919,512868
610,610.0,610.0,75.0,617,513485
611,611.0,611.0,180.0,1145,514630
612,612.0,612.0,460.0,1046,515676
613,613.0,613.0,30.0,472,516148
614,614.0,614.0,285.0,830,516978
615,615.0,615.0,75.0,687,517665
616,616.0,616.0,135.0,658,518323
617,617.0,617.0,130.0,345,518668
618,618.0,618.0,85.0,394,519062
619,619.0,619.0,235.0,1079,520141
620,620.0,620.0,270.0,867,521008
621,621.0,621.0,265.0,1582,522590
622,622.0,622.0,135.0,584,523174
623,623.0,623.0,475.0,895,524069
624,624.0,624.0,35.0,362,524431
625,625.0,625.0,125.0,509,524940
626,626.0,626.0,145.0,1035,525975
627,627.0,627.0,125.0,548,526523
628,628.0,628.0,150.0,611,527134
629,629.0,629.0,180.0,647,527781
630,630.0,630.0,245.0,1064,528845
631,631.0,631.0,15.0,331,529176
632,632.0,632.0,215.0,1112,530288
633,633.0,633.0,160.0,633,530921
634,634.0,634.0,300.0,984,531905
635,635.0,635.0,265.0,1068,532973
636,636.0,636.0,125.0,549,533522
637,637.0,637.0,255.0,831,534353
638,638.0,638.0,185.0,864,535217
639,639.0,639.0,570.0,1139,536356
640,640.0,640.0,190.0,1259,537615
641,641.0,641.0,185.0,652,538267
642,642.0,642.0,80.0,695,538962
643,643.0,643.0,190.0,962,539924
644,644.0,644.0,155.0,645,540569
645,645.0,645.0,210.0,702,541271
646,646.0,646.0,70.0,528,541799
647,647.0,647.0,195.0,875,542674
648,648.0,648.0,500.0,1347,544021
649,649.0,649.0,395.0,1240,545261
650,650.0,650.0,75.0,389,545650
651,651.0,651.0,465.0,1069,546719
652,652.0,652.0,275.0,887,547606
653,653.0,653.0,125.0,583,548189
654,654.0,654.0,135.0,659,548848
655,655.0,655.0,115.0,627,549475
656,656.0,656.0,175.0,924,550399
657,657.0,657.0,135.0,961,551360
658,658.0,658.0,280.0,1060,552420
659,659.0,659.0,220.0,891,553311
660,660.0,660.0,350.0,784,554095
661,661.0,661.0,50.0,377,554472
662,662.0,662.0,315.0,1209,555681
663,663.0,663.0,180.0,706,556387
664,664.0,664.0,500.0,1393,557780
665,665.0,665.0,315.0,1007,558787
666,666.0,666.0,255.0,1004,559791
667,667.0,667.0,320.0,1108,560899
668,668.0,668.0,315.0,1429,562328
669,669.0,669.0,430.0,1549,563877
670,670.0,670.0,390.0,1025,564902
671,671.0,671.0,295.0,626,565528
672,672.0,672.0,305.0,1046,566574
673,673.0,673.0,105.0,933,567507
674,674.0,674.0,230.0,806,568313
675,675.0,675.0,235.0,664,568977
676,676.0,676.0,245.0,827,569804
677,677.0,677.0,165.0,965,570769
678,678.0,678.0,170.0,608,571377
679,679.0,679.0,200.0,678,572055
680,680.0,680.0,130.0,610,572665
681,681.0,681.0,125.0,973,573638
682,682.0,682.0,170.0,823,574461
683,683.0,683.0,205.0,1035,575496
684,684.0,684.0,60.0,729,576225
685,685.0,685.0,150.0,853,577078
686,686.0,686.0,125.0,625,577703
687,687.0,687.0,90.0,401,578104
688,688.0,688.0,75.0,349,578453
689,689.0,689.0,390.0,1252,579705
690,690.0,690.0,155.0,701,580406
691,691.0,691.0,215.0,833,581239
692,692.0,692.0,350.0,1015,582254
693,693.0,693.0,75.0,694,582948
694,694.0,694.0,255.0,998,583946
695,695.0,695.0,565.0,1615,585561
696,696.0,696.0,85.0,656,586217
697,697.0,697.0,80.0,590,586807
698,698.0,698.0,240.0,1297,588104
699,699.0,699.0,220.0,927,589031
700,700.0,700.0,135.0,689,589720
701,701.0,701.0,395.0,1390,591110
702,702.0,702.0,75.0,781,591891
703,703.0,703.0,225.0,820,592711
704,704.0,704.0,205.0,576,593287
705,705.0,705.0,750.0,1580,594867
706,706.0,706.0,390.0,1591,596458
707,707.0,707.0,225.0,875,597333
708,708.0,708.0,160.0,672,598005
709,709.0,709.0,340.0,1029,599034
710,710.0,710.0,230.0,657,599691
711,711.0,711.0,110.0,667,600358
712,712.0,712.0,75.0,625,600983
713,713.0,713.0,65.0,668,601651
714,714.0,714.0,195.0,858,602509
715,715.0,715.0,30.0,392,602901
716,716.0,716.0,120.0,817,603718
717,717.0,717.0,115.0,678,604396
718,718.0,718.0,110.0,656,605052
719,719.0,719.0,175.0,850,605902
720,720.0,720.0,165.0,805,606707
721,721.0,721.0,105.0,625,607332
722,722.0,722.0,175.0,690,608022
723,723.0,723.0,155.0,787,608809
724,724.0,724.0,75.0,415,609224
725,725.0,725.0,225.0,998,610222
726,726.0,726.0,55.0,668,610890
727,727.0,727.0,135.0,575,611465
728,728.0,728.0,275.0,1064,612529
729,729.0,729.0,310.0,1123,613652
730,730.0,730.0,445.0,865,614517
731,731.0,731.0,405.0,1047,615564
732,732.0,732.0,170.0,661,616225
733,733.0,733.0,120.0,582,616807
734,734.0,734.0,440.0,1332,618139
735,735.0,735.0,140.0,828,618967
736,736.0,736.0,120.0,588,619555
737,737.0,737.0,210.0,813,620368
738,738.0,738.0,155.0,644,621012
739,739.0,739.0,105.0,649,621661
740,740.0,740.0,315.0,1122,622783
741,741.0,741.0,170.0,1278,624061
742,742.0,742.0,200.0,892,624953
743,743.0,743.0,80.0,403,625356
744,744.0,744.0,265.0,869,626225
745,745.0,745.0,480.0,804,627029
746,746.0,746.0,170.0,1017,628046
747,747.0,747.0,145.0,702,628748
748,748.0,748.0,220.0,879,629627
749,749.0,749.0,120.0,571,630198
750,750.0,750.0,215.0,1115,631313
751,751.0,751.0,160.0,666,631979
752,752.0,752.0,385.0,1162,633141
753,753.0,753.0,430.0,1838,634979
754,754.0,754.0,55.0,377,635356
755,755.0,755.0,125.0,692,636048
756,756.0,756.0,260.0,1063,637111
757,757.0,757.0,110.0,714,637825
758,758.0,758.0,165.0,636,638461
759,759.0,759.0,130.0,894,639355
760,760.0,760.0,465.0,1087,640442
761,761.0,761.0,210.0,660,641102
762,762.0,762.0,70.0,509,641611
763,763.0,763.0,1100.0,1806,643417
764,764.0,764.0,175.0,1005,644422
765,765.0,765.0,30.0,358,644780
766,766.0,766.0,135.0,573,645353
767,767.0,767.0,170.0,798,646151
768,768.0,768.0,295.0,1148,647299
769,769.0,769.0,170.0,688,647987
770,770.0,770.0,230.0,816,648803
771,771.0,771.0,150.0,607,649410
772,772.0,772.0,145.0,1059,650469
773,773.0,773.0,180.0,1148,651617
774,774.0,774.0,205.0,1046,652663
775,775.0,775.0,175.0,677,653340
776,776.0,776.0,90.0,678,654018
777,777.0,777.0,175.0,977,654995
778,778.0,778.0,365.0,1168,656163
779,779.0,779.0,760.0,1231,657394
780,780.0,780.0,170.0,793,658187
781,781.0,781.0,200.0,718,658905
782,782.0,782.0,490.0,1328,660233
783,783.0,783.0,55.0,412,660645
784,784.0,784.0,270.0,996,661641
785,785.0,785.0,240.0,890,662531
786,786.0,786.0,300.0,1029,663560
787,787.0,787.0,360.0,933,664493
788,788.0,788.0,110.0,659,665152
789,789.0,789.0,65.0,608,665760
790,790.0,790.0,500.0,1458,667218
791,791.0,791.0,115.0,662,667880
792,792.0,792.0,120.0,482,668362
793,793.0,793.0,155.0,615,668977
794,794.0,794.0,225.0,814,669791
795,795.0,795.0,365.0,1205,670996
796,796.0,796.0,135.0,600,671596
797,797.0,797.0,210.0,917,672513
798,798.0,798.0,225.0,1005,673518
799,799.0,799.0,95.0,814,674332
800,800.0,800.0,75.0,383,674715
801,801.0,801.0,105.0,433,675148
802,802.0,802.0,125.0,662,675810
803,803.0,803.0,140.0,741,676551
804,804.0,804.0,190.0,791,677342
805,805.0,805.0,85.0,670,678012
806,806.0,806.0,225.0,1071,679083
807,807.0,807.0,255.0,884,679967
808,808.0,808.0,180.0,620,680587
809,809.0,809.0,50.0,333,680920
810,810.0,810.0,455.0,765,681685
811,811.0,811.0,315.0,1135,682820
812,812.0,812.0,285.0,974,683794
813,813.0,813.0,135.0,682,684476
814,814.0,814.0,255.0,1022,685498
815,815.0,815.0,265.0,851,686349
816,816.0,816.0,115.0,917,687266
817,817.0,817.0,140.0,623,687889
818,818.0,818.0,180.0,666,688555
819,819.0,819.0,370.0,1095,689650
820,820.0,820.0,280.0,873,690523
821,821.0,821.0,315.0,1144,691667
822,822.0,822.0,260.0,692,692359
823,823.0,823.0,245.0,933,693292
824,824.0,824.0,430.0,1192,694484
825,825.0,825.0,110.0,417,694901
826,826.0,826.0,580.0,1651,696552
827,827.0,827.0,245.0,1101,697653
828,828.0,828.0,80.0,430,698083
829,829.0,829.0,555.0,1890,699973
830,0.0,,225.0,792,792
831,1.0,,265.0,786,1578
832,2.0,,210.0,804,2382
833,3.0,,265.0,945,3327
834,4.0,,210.0,823,4150
835,5.0,,260.0,984,5134
836,6.0,,465.0,1255,6389
837,7.0,,110.0,519,6908
838,8.0,,210.0,816,7724
839,9.0,,210.0,768,8492
840,10.0,,210.0,636,9128
841,11.0,,225.0,764,9892
842,12.0,,105.0,502,10394
843,13.0,,330.0,946,11340
844,14.0,,295.0,741,12081
845,15.0,,165.0,642,12723
846,16.0,,160.0,692,13415
847,17.0,,210.0,668,14083
848,18.0,,220.0,687,14770
849,19.0,,55.0,415,15185
850,20.0,,200.0,614,15799
851,21.0,,475.0,1282,17081
852,22.0,,260.0,1353,18434
853,23.0,,460.0,1353,19787
854,24.0,,125.0,664,20451
855,25.0,,10.0,384,20835
856,26.0,,65.0,670,21505
857,27.0,,175.0,945,22450
858,28.0,,215.0,791,23241
859,29.0,,135.0,666,23907
860,30.0,,280.0,763,24670
861,31.0,,170.0,650,25320
862,32.0,,135.0,635,25955
863,33.0,,260.0,883,26838
864,34.0,,185.0,681,27519
865,35.0,,280.0,1043,28562
866,36.0,,205.0,961,29523
867,37.0,,200.0,931,30454
868,38.0,,130.0,609,31063
869,39.0,,195.0,638,31701
870,40.0,,295.0,918,32619
871,41.0,,190.0,963,33582
872,42.0,,150.0,655,34237
873,43.0,,150.0,645,34882
874,44.0,,145.0,572,35454
875,45.0,,250.0,894,36348
876,46.0,,165.0,970,37318
877,47.0,,205.0,577,37895
878,48.0,,550.0,1669,39564
879,49.0,,310.0,970,40534
880,50.0,,160.0,605,41139
881,51.0,,60.0,445,41584
882,52.0,,165.0,653,42237
883,53.0,,305.0,1080,43317
884,54.0,,245.0,619,43936
885,55.0,,195.0,681,44617
886,56.0,,180.0,699,45316
887,57.0,,165.0,1059,46375
888,58.0,,545.0,1519,47894
889,59.0,,280.0,1035,48929
890,60.0,,160.0,791,49720
891,61.0,,50.0,581,50301
892,62.0,,375.0,1340,51641
893,63.0,,220.0,894,52535
894,64.0,,340.0,897,53432
895,65.0,,65.0,604,54036
896,66.0,,110.0,669,54705
897,67.0,,245.0,817,55522
898,68.0,,405.0,1363,56885
899,69.0,,110.0,705,57590
900,70.0,,75.0,371,57961
901,71.0,,150.0,881,58842
902,72.0,,90.0,378,59220
903,73.0,,80.0,629,59849
904,74.0,,365.0,794,60643
905,75.0,,235.0,1065,61708
906,76.0,,155.0,803,62511
907,77.0,,50.0,636,63147
908,78.0,,100.0,619,63766
909,79.0,,90.0,667,64433
910,80.0,,245.0,752,65185
911,81.0,,75.0,399,65584
912,82.0,,165.0,772,66356
913,83.0,,20.0,519,66875
914,84.0,,95.0,459,67334
915,85.0,,60.0,523,67857
916,86.0,,185.0,908,68765
917,87.0,,150.0,663,69428
918,88.0,,230.0,834,70262
919,89.0,,185.0,1128,71390
920,90.0,,120.0,479,71869
921,91.0,,255.0,1080,72949
922,92.0,,210.0,813,73762
923,93.0,,230.0,802,74564
924,94.0,,185.0,548,75112
925,95.0,,260.0,1076,76188
926,96.0,,180.0,658,76846
927,97.0,,120.0,901,77747
928,98.0,,225.0,1111,78858
929,99.0,,135.0,676,79534
930,100.0,,500.0,916,80450
931,101.0,,400.0,938,81388
932,102.0,,115.0,759,82147
933,103.0,,110.0,697,82844
934,104.0,,70.0,591,83435
935,105.0,,270.0,1398,84833
936,106.0,,580.0,1669,86502
937,107.0,,215.0,973,87475
938,108.0,,80.0,652,88127
939,109.0,,200.0,946,89073
940,110.0,,50.0,688,89761
941,111.0,,35.0,333,90094
942,112.0,,110.0,639,90733
943,113.0,,50.0,346,91079
944,114.0,,215.0,1224,92303
945,115.0,,205.0,829,93132
946,116.0,,440.0,1350,94482
947,117.0,,210.0,853,95335
948,118.0,,165.0,932,96267
949,119.0,,125.0,654,96921
950,120.0,,105.0,692,97613
951,121.0,,290.0,1047,98660
952,122.0,,525.0,1029,99689
953,123.0,,210.0,931,100620
954,124.0,,225.0,1180,101800
955,125.0,,20.0,643,102443
956,126.0,,75.0,519,102962
957,127.0,,50.0,508,103470
958,128.0,,270.0,1136,104606
959,129.0,,105.0,544,105150
960,130.0,,135.0,573,105723
961,131.0,,240.0,948,106671
962,132.0,,295.0,1006,107677
963,133.0,,140.0,775,108452
964,134.0,,35.0,390,108842
965,135.0,,285.0,702,109544
966,136.0,,75.0,691,110235
967,137.0,,115.0,653,110888
968,138.0,,75.0,670,111558
969,139.0,,135.0,1096,112654
970,140.0,,270.0,1105,113759
971,141.0,,105.0,690,114449
972,142.0,,135.0,648,115097
973,143.0,,105.0,644,115741
974,144.0,,235.0,937,116678
975,145.0,,325.0,1094,117772
976,146.0,,105.0,697,118469
977,147.0,,320.0,1590,120059
978,148.0,,15.0,512,120571
979,149.0,,105.0,628,121199
980,150.0,,255.0,952,122151
981,151.0,,105.0,486,122637
982,152.0,,75.0,424,123061
983,153.0,,180.0,1019,124080
984,154.0,,165.0,929,125009
985,155.0,,135.0,760,125769
986,156.0,,280.0,1244,127013
987,157.0,,465.0,1437,128450
988,158.0,,85.0,731,129181
989,159.0,,55.0,404,129585
990,160.0,,105.0,570,130155
991,161.0,,365.0,1251,131406
992,162.0,,75.0,365,131771
993,163.0,,165.0,764,132535
994,164.0,,105.0,477,133012
995,165.0,,100.0,480,133492
996,166.0,,120.0,540,134032
997,167.0,,135.0,555,134587
998,168.0,,250.0,1265,135852
999,169.0,,780.0,1536,137388
1000,170.0,,135.0,676,138064
1001,171.0,,145.0,1145,139209
1002,172.0,,500.0,1250,140459
1003,173.0,,105.0,472,140931
1004,174.0,,165.0,781,141712
1005,175.0,,205.0,922,142634
1006,176.0,,140.0,676,143310
1007,177.0,,135.0,692,144002
1008,178.0,,65.0,478,144480
1009,179.0,,180.0,668,145148
1010,180.0,,105.0,506,145654
1011,181.0,,75.0,702,146356
1012,182.0,,120.0,754,147110
1013,183.0,,510.0,1070,148180
1014,184.0,,400.0,1363,149543
1015,185.0,,80.0,549,150092
1016,186.0,,130.0,952,151044
1017,187.0,,110.0,435,151479
1018,188.0,,260.0,949,152428
1019,189.0,,55.0,572,153000
1020,190.0,,65.0,363,153363
1021,191.0,,540.0,1402,154765
1022,192.0,,115.0,655,155420
1023,193.0,,20.0,575,155995
1024,194.0,,285.0,1031,157026
1025,195.0,,10.0,481,157507
1026,196.0,,110.0,533,158040
1027,197.0,,75.0,407,158447
1028,198.0,,330.0,1622,160069
1029,199.0,,180.0,641,160710
1030,200.0,,105.0,497,161207
1031,201.0,,120.0,645,161852
1032,202.0,,455.0,1251,163103
1033,203.0,,285.0,975,164078
1034,204.0,,70.0,503,164581
1035,205.0,,200.0,755,165336
1036,206.0,,335.0,1220,166556
1037,207.0,,85.0,703,167259
1038,208.0,,235.0,1043,168302
1039,209.0,,105.0,447,168749
1040,210.0,,115.0,1225,169974
1041,211.0,,130.0,649,170623
1042,212.0,,660.0,1942,172565
1043,213.0,,30.0,378,172943
1044,214.0,,305.0,1113,174056
1045,215.0,,135.0,484,174540
1046,216.0,,280.0,978,175518
1047,217.0,,260.0,957,176475
1048,218.0,,70.0,920,177395
1049,219.0,,140.0,623,178018
1050,220.0,,175.0,897,178915
1051,221.0,,55.0,903,179818
1052,222.0,,75.0,377,180195
1053,223.0,,150.0,663,180858
1054,224.0,,260.0,940,181798
1055,225.0,,325.0,845,182643
1056,226.0,,350.0,1435,184078
1057,227.0,,210.0,839,184917
1058,228.0,,140.0,741,185658
1059,229.0,,260.0,943,186601
1060,230.0,,35.0,424,187025
1061,231.0,,310.0,1404,188429
1062,232.0,,120.0,804,189233
1063,233.0,,190.0,800,190033
1064,234.0,,30.0,656,190689
1065,235.0,,105.0,762,191451
1066,236.0,,175.0,941,192392
1067,237.0,,350.0,1116,193508
1068,238.0,,100.0,377,193885
1069,239.0,,185.0,871,194756
1070,240.0,,60.0,689,195445
1071,241.0,,75.0,371,195816
1072,242.0,,105.0,535,196351
1073,243.0,,50.0,648,196999
1074,244.0,,110.0,814,197813
1075,245.0,,110.0,729,198542
1076,246.0,,145.0,648,199190
1077,247.0,,190.0,920,200110
1078,248.0,,435.0,1539,201649
1079,249.0,,385.0,1245,202894
1080,250.0,,300.0,1383,204277
1081,251.0,,180.0,847,205124
1082,252.0,,155.0,1057,206181
1083,253.0,,225.0,749,206930
1084,254.0,,280.0,1295,208225
1085,255.0,,240.0,686,208911
1086,256.0,,115.0,669,209580
1087,257.0,,120.0,681,210261
1088,258.0,,205.0,1128,211389
1089,259.0,,390.0,955,212344
1090,260.0,,120.0,819,213163
1091,261.0,,470.0,1098,214261
1092,262.0,,90.0,698,214959
1093,263.0,,180.0,819,215778
1094,264.0,,360.0,950,216728
1095,265.0,,150.0,668,217396
1096,266.0,,100.0,810,218206
1097,267.0,,105.0,669,218875
1098,268.0,,105.0,589,219464
1099,269.0,,165.0,1072,220536
1100,270.0,,155.0,719,221255
1101,271.0,,65.0,599,221854
1102,272.0,,110.0,663,222517
1103,273.0,,125.0,857,223374
1104,274.0,,105.0,405,223779
1105,275.0,,180.0,927,224706
1106,276.0,,130.0,642,225348
1107,277.0,,170.0,926,226274
1108,278.0,,160.0,812,227086
1109,279.0,,140.0,687,227773
1110,280.0,,220.0,823,228596
1111,281.0,,105.0,590,229186
1112,282.0,,210.0,941,230127
1113,283.0,,105.0,641,230768
1114,284.0,,370.0,1798,232566
1115,285.0,,110.0,377,232943
1116,286.0,,110.0,860,233803
1117,287.0,,170.0,915,234718
1118,288.0,,175.0,834,235552
1119,289.0,,120.0,661,236213
1120,290.0,,55.0,637,236850
1121,291.0,,185.0,872,237722
1122,292.0,,145.0,807,238529
1123,293.0,,345.0,985,239514
1124,294.0,,20.0,488,240002
1125,295.0,,205.0,854,240856
1126,296.0,,130.0,783,241639
1127,297.0,,145.0,651,242290
1128,298.0,,370.0,963,243253
1129,299.0,,180.0,811,244064
1130,300.0,,525.0,1354,245418
1131,301.0,,225.0,1405,246823
1132,302.0,,215.0,1001,247824
1133,303.0,,400.0,1346,249170
1134,304.0,,185.0,1283,250453
1135,305.0,,140.0,787,251240
1136,306.0,,105.0,437,251677
1137,307.0,,220.0,845,252522
1138,308.0,,240.0,995,253517
1139,309.0,,115.0,707,254224
1140,310.0,,590.0,1075,255299
1141,311.0,,185.0,829,256128
1142,312.0,,190.0,755,256883
1143,313.0,,215.0,822,257705
1144,314.0,,270.0,1145,258850
1145,315.0,,210.0,1110,259960
1146,316.0,,430.0,1377,261337
1147,317.0,,105.0,658,261995
1148,318.0,,590.0,1401,263396
1149,319.0,,210.0,821,264217
1150,320.0,,65.0,680,264897
1151,321.0,,210.0,844,265741
1152,322.0,,495.0,1387,267128
1153,323.0,,130.0,634,267762
1154,324.0,,105.0,667,268429
1155,325.0,,110.0,612,269041
1156,326.0,,75.0,508,269549
1157,327.0,,370.0,930,270479
1158,328.0,,175.0,793,271272
1159,329.0,,210.0,931,272203
1160,330.0,,180.0,853,273056
1161,331.0,,120.0,651,273707
1162,332.0,,235.0,876,274583
1163,333.0,,125.0,955,275538
1164,334.0,,105.0,673,276211
1165,335.0,,70.0,449,276660
1166,336.0,,105.0,668,277328
1167,337.0,,90.0,515,277843
1168,338.0,,130.0,969,278812
1169,339.0,,455.0,1238,280050
1170,340.0,,95.0,713,280763
1171,341.0,,100.0,667,281430
1172,342.0,,75.0,690,282120
1173,343.0,,165.0,634,282754
1174,344.0,,240.0,879,283633
1175,345.0,,325.0,1019,284652
1176,346.0,,30.0,403,285055
1177,347.0,,265.0,895,285950
1178,348.0,,105.0,672,286622
1179,349.0,,115.0,503,287125
1180,350.0,,535.0,1469,288594
1181,351.0,,170.0,810,289404
1182,352.0,,75.0,410,289814
1183,353.0,,75.0,720,290534
1184,354.0,,160.0,1318,291852
1185,355.0,,80.0,529,292381
1186,356.0,,115.0,940,293321
1187,357.0,,155.0,640,293961
1188,358.0,,180.0,792,294753
1189,359.0,,135.0,654,295407
1190,360.0,,415.0,1277,296684
1191,361.0,,110.0,647,297331
1192,362.0,,110.0,862,298193
1193,363.0,,55.0,687,298880
1194,364.0,,180.0,799,299679
1195,365.0,,130.0,857,300536
1196,366.0,,145.0,918,301454
1197,367.0,,30.0,519,301973
1198,368.0,,385.0,1611,303584
1199,369.0,,220.0,977,304561
1200,370.0,,130.0,665,305226
1201,371.0,,55.0,615,305841
1202,372.0,,50.0,356,306197
1203,373.0,,105.0,644,306841
1204,374.0,,105.0,697,307538
1205,375.0,,155.0,994,308532
1206,376.0,,50.0,568,309100
1207,377.0,,135.0,846,309946
1208,378.0,,105.0,671,310617
1209,379.0,,140.0,545,311162
1210,380.0,,155.0,688,311850
1211,381.0,,210.0,1088,312938
1212,382.0,,55.0,405,313343
1213,383.0,,120.0,588,313931
1214,384.0,,120.0,841,314772
1215,385.0,,230.0,840,315612
1216,386.0,,215.0,791,316403
1217,387.0,,175.0,802,317205
1218,388.0,,210.0,835,318040
1219,389.0,,10.0,659,318699
1220,390.0,,15.0,340,319039
1221,391.0,,135.0,694,319733
1222,392.0,,235.0,1068,320801
1223,393.0,,160.0,819,321620
1224,394.0,,75.0,405,322025
1225,395.0,,195.0,832,322857
1226,396.0,,50.0,571,323428
1227,397.0,,410.0,854,324282
1228,398.0,,50.0,1158,325440
1229,399.0,,235.0,1086,326526
1230,400.0,,130.0,892,327418
1231,401.0,,210.0,814,328232
1232,402.0,,110.0,819,329051
1233,403.0,,410.0,1653,330704
1234,404.0,,290.0,1087,331791
1235,405.0,,15.0,492,332283
1236,406.0,,325.0,1189,333472
1237,407.0,,160.0,926,334398
1238,408.0,,180.0,819,335217
1239,409.0,,125.0,718,335935
1240,410.0,,90.0,701,336636
1241,411.0,,70.0,520,337156
1242,412.0,,45.0,630,337786
1243,413.0,,360.0,838,338624
1244,414.0,,175.0,817,339441
1245,415.0,,80.0,697,340138
1246,416.0,,50.0,641,340779
1247,417.0,,5.0,694,341473
1248,418.0,,20.0,573,342046
1249,419.0,,365.0,1094,343140
1250,420.0,,215.0,798,343938
1251,421.0,,40.0,672,344610
1252,422.0,,110.0,542,345152
1253,423.0,,655.0,1461,346613
1254,424.0,,270.0,918,347531
1255,425.0,,160.0,715,348246
1256,426.0,,120.0,665,348911
1257,427.0,,380.0,1402,350313
1258,428.0,,265.0,1152,351465
1259,429.0,,85.0,660,352125
1260,430.0,,475.0,1478,353603
1261,431.0,,35.0,644,354247
1262,432.0,,140.0,814,355061
1263,433.0,,185.0,800,355861
1264,434.0,,155.0,810,356671
1265,435.0,,215.0,674,357345
1266,436.0,,65.0,457,357802
1267,437.0,,105.0,664,358466
1268,438.0,,290.0,1380,359846
1269,439.0,,250.0,1050,360896
1270,440.0,,490.0,1491,362387
1271,441.0,,75.0,386,362773
1272,442.0,,170.0,1387,364160
1273,443.0,,70.0,641,364801
1274,444.0,,545.0,1404,366205
1275,445.0,,755.0,1850,368055
1276,446.0,,80.0,819,368874
1277,447.0,,185.0,787,369661
1278,448.0,,260.0,975,370636
1279,449.0,,160.0,802,371438
1280,450.0,,435.0,882,372320
1281,451.0,,225.0,1168,373488
1282,452.0,,190.0,923,374411
1283,453.0,,310.0,1259,375670
1284,454.0,,430.0,801,376471
1285,455.0,,570.0,1410,377881
1286,456.0,,105.0,710,378591
1287,457.0,,210.0,835,379426
1288,458.0,,190.0,679,380105
1289,459.0,,550.0,1183,381288
1290,460.0,,345.0,1083,382371
1291,461.0,,130.0,615,382986
1292,462.0,,110.0,705,383691
1293,463.0,,505.0,1044,384735
1294,464.0,,205.0,1368,386103
1295,465.0,,155.0,691,386794
1296,466.0,,185.0,836,387630
1297,467.0,,110.0,664,388294
1298,468.0,,190.0,776,389070
1299,469.0,,175.0,737,389807
1300,470.0,,120.0,701,390508
1301,471.0,,155.0,547,391055
1302,472.0,,435.0,1322,392377
1303,473.0,,90.0,650,393027
1304,474.0,,430.0,1240,394267
1305,475.0,,355.0,944,395211
1306,476.0,,215.0,951,396162
1307,477.0,,105.0,481,396643
1308,478.0,,85.0,514,397157
1309,479.0,,200.0,1098,398255
1310,480.0,,105.0,628,398883
1311,481.0,,30.0,385,399268
1312,482.0,,115.0,1315,400583
1313,483.0,,105.0,754,401337
1314,484.0,,80.0,640,401977
1315,485.0,,340.0,838,402815
1316,486.0,,305.0,688,403503
1317,487.0,,380.0,854,404357
1318,488.0,,115.0,658,405015
1319,489.0,,575.0,1215,406230
1320,490.0,,370.0,1070,407300
1321,491.0,,135.0,651,407951
1322,492.0,,300.0,948,408899
1323,493.0,,365.0,1133,410032
1324,494.0,,200.0,810,410842
1325,495.0,,220.0,1169,412011
1326,496.0,,30.0,649,412660
1327,497.0,,250.0,1319,413979
1328,498.0,,370.0,862,414841
1329,499.0,,120.0,921,415762
1330,500.0,,190.0,1211,416973
1331,501.0,,505.0,1219,418192
1332,502.0,,285.0,1154,419346
1333,503.0,,255.0,1031,420377
1334,504.0,,80.0,425,420802
1335,505.0,,120.0,651,421453
1336,506.0,,110.0,643,422096
1337,507.0,,330.0,1513,423609
1338,508.0,,175.0,864,424473
1339,509.0,,225.0,930,425403
1340,510.0,,105.0,914,426317
1341,511.0,,180.0,969,427286
1342,512.0,,350.0,1325,428611
1343,513.0,,245.0,658,429269
1344,514.0,,180.0,932,430201
1345,515.0,,250.0,1137,431338
1346,516.0,,385.0,1431,432769
1347,517.0,,880.0,2067,434836
1348,518.0,,315.0,1174,436010
1349,519.0,,360.0,828,436838
1350,520.0,,100.0,704,437542
1351,521.0,,210.0,725,438267
1352,522.0,,380.0,948,439215
1353,523.0,,35.0,463,439678
1354,524.0,,140.0,1050,440728
1355,525.0,,260.0,818,441546
1356,526.0,,150.0,934,442480
1357,527.0,,220.0,680,443160
1358,528.0,,320.0,1295,444455
1359,529.0,,85.0,372,444827
1360,530.0,,245.0,886,445713
1361,531.0,,110.0,513,446226
1362,532.0,,140.0,686,446912
1363,533.0,,255.0,1323,448235
1364,534.0,,310.0,1047,449282
1365,535.0,,160.0,915,450197
1366,536.0,,90.0,715,450912
1367,537.0,,270.0,1175,452087
1368,538.0,,410.0,824,452911
1369,539.0,,45.0,581,453492
1370,540.0,,85.0,513,454005
1371,541.0,,185.0,820,454825
1372,542.0,,395.0,1271,456096
1373,543.0,,220.0,1093,457189
1374,544.0,,510.0,1596,458785
1375,545.0,,175.0,854,459639
0,,,170.0,701,701
1,,,180.0,842,1543
2,,,155.0,816,2359
3,,,75.0,658,3017
4,,,50.0,655,3672
5,,,50.0,675,4347
6,,,50.0,690,5037
7,,,30.0,679,5716
8,,,50.0,649,6365
9,,,15.0,641,7006
10,,,410.0,1411,8417
11,,,50.0,645,9062
12,,,110.0,1263,10325
13,,,340.0,830,11155
14,,,135.0,842,11997
15,,,180.0,879,12876
16,,,260.0,1023,13899
17,,,155.0,800,14699
18,,,75.0,711,15410
19,,,210.0,819,16229
20,,,105.0,604,16833
21,,,210.0,825,17658
22,,,245.0,986,18644
23,,,105.0,920,19564
24,,,185.0,687,20251
25,,,210.0,870,21121
26,,,120.0,489,21610
27,,,40.0,680,22290
28,,,240.0,1124,23414
29,,,155.0,808,24222
30,,,210.0,1407,25629
31,,,240.0,965,26594
32,,,255.0,1282,27876
33,,,235.0,790,28666
34,,,110.0,383,29049
35,,,295.0,971,30020
36,,,90.0,976,30996
37,,,75.0,424,31420
38,,,285.0,1281,32701
39,,,25.0,487,33188
40,,,260.0,1195,34383
41,,,290.0,908,35291
42,,,210.0,773,36064
43,,,180.0,812,36876
44,,,745.0,1666,38542
45,,,165.0,688,39230
46,,,435.0,823,40053
47,,,130.0,708,40761
48,,,175.0,913,41674
49,,,115.0,814,42488
50,,,130.0,943,43431
51,,,80.0,526,43957
52,,,120.0,711,44668
53,,,120.0,382,45050
54,,,210.0,930,45980
55,,,80.0,466,46446
56,,,105.0,983,47429
57,,,75.0,711,48140
58,,,180.0,807,48947
59,,,340.0,1243,50190
60,,,480.0,1147,51337
61,,,250.0,740,52077
62,,,160.0,583,52660
63,,,570.0,1287,53947
64,,,365.0,1228,55175
65,,,320.0,994,56169
66,,,155.0,634,56803
67,,,525.0,1120,57923
68,,,330.0,967,58890
69,,,500.0,1642,60532
70,,,305.0,1525,62057
71,,,140.0,672,62729
72,,,80.0,403,63132
73,,,450.0,1583,64715
74,,,85.0,642,65357
75,,,390.0,1275,66632
76,,,105.0,426,67058
77,,,475.0,1075,68133
78,,,210.0,657,68790
79,,,255.0,1064,69854
80,,,535.0,1309,71163
81,,,165.0,790,71953
82,,,220.0,659,72612
83,,,105.0,615,73227
84,,,635.0,1651,74878
85,,,110.0,801,75679
86,,,240.0,1033,76712
87,,,105.0,543,77255
88,,,65.0,517,77772
89,,,150.0,527,78299
90,,,315.0,1086,79385
91,,,530.0,1137,80522
92,,,210.0,789,81311
93,,,135.0,450,81761
94,,,270.0,867,82628
95,,,190.0,835,83463
96,,,240.0,863,84326
97,,,200.0,632,84958
98,,,185.0,671,85629
99,,,305.0,863,86492
100,,,240.0,1098,87590
101,,,50.0,702,88292
102,,,600.0,2014,90306
103,,,40.0,510,90816
104,,,210.0,1097,91913
105,,,30.0,340,92253
106,,,215.0,968,93221
107,,,145.0,781,94002
108,,,365.0,1011,95013
109,,,160.0,664,95677
110,,,80.0,392,96069
111,,,295.0,969,97038
112,,,110.0,658,97696
113,,,380.0,875,98571
114,,,110.0,1129,99700
115,,,365.0,1309,101009
116,,,350.0,1090,102099
117,,,275.0,1050,103149
118,,,140.0,617,103766
119,,,110.0,532,104298
120,,,340.0,1536,105834
121,,,260.0,938,106772
122,,,170.0,960,107732
123,,,140.0,863,108595
124,,,75.0,640,109235
125,,,110.0,537,109772
126,,,115.0,543,110315
127,,,125.0,380,110695
128,,,75.0,513,111208
129,,,105.0,732,111940
130,,,285.0,1054,112994
131,,,105.0,366,113360
132,,,815.0,1671,115031
133,,,195.0,854,115885
134,,,360.0,921,116806
135,,,535.0,1106,117912
136,,,160.0,975,118887
137,,,20.0,651,119538
138,,,180.0,797,120335
139,,,110.0,580,120915
140,,,50.0,360,121275
141,,,130.0,608,121883
142,,,160.0,947,122830
143,,,385.0,1296,124126
144,,,260.0,856,124982
145,,,110.0,595,125577
146,,,265.0,774,126351
147,,,110.0,493,126844
148,,,110.0,798,127642
149,,,505.0,1152,128794
150,,,105.0,491,129285
151,,,280.0,979,130264
152,,,150.0,1052,131316
153,,,130.0,644,131960
154,,,130.0,623,132583
155,,,410.0,1036,133619
156,,,385.0,1496,135115
157,,,195.0,1038,136153
158,,,465.0,1075,137228
159,,,140.0,664,137892
160,,,140.0,695,138587
161,,,315.0,904,139491
162,,,170.0,708,140199
163,,,250.0,1155,141354
164,,,110.0,646,142000
165,,,275.0,1092,143092
166,,,125.0,522,143614
167,,,160.0,791,144405
168,,,330.0,909,145314
169,,,370.0,1596,146910
170,,,330.0,894,147804
171,,,130.0,498,148302
172,,,105.0,395,148697
173,,,545.0,1447,150144
174,,,205.0,666,150810
175,,,115.0,671,151481
176,,,190.0,849,152330
177,,,190.0,731,153061
178,,,150.0,741,153802
179,,,200.0,712,154514
180,,,125.0,517,155031
181,,,40.0,929,155960
182,,,450.0,1373,157333
183,,,345.0,1112,158445
184,,,135.0,624,159069
185,,,210.0,942,160011
186,,,50.0,373,160384
187,,,215.0,521,160905
188,,,125.0,693,161598
189,,,365.0,1042,162640
190,,,85.0,639,163279
191,,,110.0,504,163783
192,,,200.0,636,164419
193,,,150.0,821,165240
194,,,465.0,1291,166531
195,,,75.0,359,166890
196,,,150.0,584,167474
197,,,320.0,1091,168565
198,,,235.0,878,169443
199,,,310.0,1223,170666
200,,,370.0,1237,171903
201,,,35.0,452,172355
202,,,190.0,857,173212
203,,,155.0,638,173850
204,,,570.0,1029,174879
205,,,205.0,754,175633
206,,,370.0,1152,176785
207,,,200.0,728,177513
208,,,80.0,371,177884
209,,,260.0,820,178704
210,,,85.0,535,179239
211,,,85.0,496,179735
212,,,65.0,611,180346
213,,,75.0,349,180695
214,,,345.0,1017,181712
215,,,305.0,1337,183049
216,,,90.0,637,183686
217,,,200.0,978,184664
218,,,115.0,673,185337
219,,,35.0,359,185696
220,,,400.0,896,186592
221,,,180.0,1020,187612
222,,,90.0,515,188127
223,,,120.0,642,188769
224,,,275.0,1143,189912
225,,,275.0,934,190846
226,,,315.0,1052,191898
227,,,150.0,796,192694
228,,,155.0,676,193370
229,,,110.0,914,194284
230,,,380.0,1055,195339
231,,,185.0,954,196293
232,,,510.0,852,197145
233,,,15.0,332,197477
234,,,495.0,1105,198582
235,,,185.0,917,199499
236,,,210.0,925,200424
237,,,425.0,1317,201741
238,,,140.0,783,202524
239,,,185.0,870,203394
240,,,290.0,1149,204543
241,,,75.0,377,204920
242,,,455.0,1203,206123
243,,,380.0,1520,207643
244,,,215.0,914,208557
245,,,290.0,937,209494
246,,,565.0,1125,210619
247,,,90.0,562,211181
248,,,185.0,994,212175
249,,,155.0,736,212911
250,,,25.0,503,213414
251,,,385.0,808,214222
252,,,160.0,611,214833
253,,,345.0,1276,216109
254,,,100.0,683,216792
255,,,125.0,702,217494
256,,,330.0,1288,218782
257,,,325.0,861,219643
258,,,175.0,855,220498
259,,,95.0,537,221035
260,,,35.0,518,221553
261,,,260.0,999,222552
262,,,125.0,637,223189
263,,,80.0,382,223571
264,,,495.0,1322,224893
265,,,145.0,727,225620
266,,,135.0,487,226107
267,,,455.0,1116,227223
268,,,175.0,861,228084
269,,,45.0,368,228452
270,,,245.0,836,229288
271,,,180.0,799,230087
272,,,410.0,837,230924
273,,,185.0,902,231826
274,,,165.0,712,232538
275,,,85.0,489,233027
276,,,155.0,673,233700
277,,,350.0,1242,234942
278,,,145.0,539,235481
279,,,55.0,418,235899
280,,,785.0,1739,237638
281,,,465.0,1149,238787
282,,,165.0,703,239490
283,,,120.0,601,240091
284,,,150.0,877,240968
285,,,35.0,340,241308
286,,,255.0,601,241909
287,,,205.0,864,242773
288,,,550.0,1213,243986
289,,,520.0,1328,245314
290,,,200.0,691,246005
291,,,35.0,344,246349
292,,,80.0,389,246738
293,,,185.0,684,247422
294,,,250.0,1035,248457
295,,,40.0,371,248828
296,,,320.0,1056,249884
297,,,135.0,651,250535
298,,,60.0,518,251053
299,,,50.0,375,251428
300,,,140.0,521,251949
301,,,165.0,681,252630
302,,,25.0,515,253145
303,,,175.0,995,254140
304,,,75.0,569,254709
305,,,190.0,728,255437
306,,,225.0,891,256328
307,,,135.0,608,256936
308,,,115.0,655,257591
309,,,275.0,1051,258642
310,,,170.0,987,259629
311,,,120.0,481,260110
312,,,145.0,861,260971
313,,,480.0,778,261749
314,,,500.0,1437,263186
315,,,75.0,380,263566
316,,,465.0,1240,264806
317,,,445.0,1360,266166
318,,,155.0,828,266994
319,,,145.0,643,267637
320,,,350.0,873,268510
321,,,115.0,522,269032
322,,,700.0,1380,270412
323,,,155.0,855,271267
324,,,135.0,721,271988
325,,,305.0,1041,273029
326,,,210.0,641,273670
327,,,620.0,1363,275033
328,,,40.0,528,275561
329,,,160.0,934,276495
330,,,165.0,671,277166
331,,,280.0,1288,278454
332,,,15.0,352,278806
333,,,55.0,606,279412
334,,,165.0,947,280359
335,,,175.0,907,281266
336,,,105.0,639,281905
337,,,170.0,1043,282948
338,,,440.0,1300,284248
339,,,415.0,720,284968
340,,,235.0,920,285888
341,,,275.0,1023,286911
342,,,345.0,1086,287997
343,,,65.0,413,288410
344,,,500.0,1292,289702
345,,,470.0,1038,290740
346,,,160.0,692,291432
347,,,285.0,811,292243
348,,,115.0,743,292986
349,,,220.0,1119,294105
350,,,180.0,628,294733
351,,,50.0,649,295382
352,,,440.0,1190,296572
353,,,135.0,657,297229
354,,,35.0,330,297559
355,,,110.0,904,298463
356,,,115.0,483,298946
357,,,175.0,620,299566
358,,,245.0,840,300406
359,,,165.0,838,301244
360,,,250.0,696,301940
361,,,245.0,862,302802
362,,,215.0,949,303751
363,,,575.0,934,304685
364,,,65.0,526,305211
365,,,250.0,1012,306223
366,,,135.0,661,306884
367,,,455.0,1306,308190
368,,,245.0,916,309106
369,,,280.0,1128,310234
370,,,250.0,850,311084
371,,,160.0,799,311883
372,,,140.0,922,312805
373,,,20.0,428,313233
374,,,70.0,510,313743
375,,,175.0,632,314375
376,,,30.0,591,314966
377,,,160.0,1119,316085
378,,,480.0,1148,317233
379,,,115.0,944,318177
380,,,95.0,707,318884
381,,,215.0,797,319681
382,,,340.0,806,320487
383,,,135.0,907,321394
384,,,665.0,1787,323181
385,,,255.0,872,324053
386,,,40.0,400,324453
387,,,210.0,841,325294
388,,,340.0,1314,326608
389,,,245.0,1079,327687
390,,,110.0,722,328409
391,,,35.0,507,328916
392,,,165.0,808,329724
393,,,185.0,637,330361
394,,,120.0,633,330994
395,,,105.0,478,331472
396,,,520.0,1368,332840
397,,,470.0,1243,334083
398,,,265.0,1053,335136
399,,,195.0,621,335757
400,,,180.0,930,336687
401,,,15.0,510,337197
402,,,155.0,668,337865
403,,,95.0,787,338652
404,,,140.0,863,339515
405,,,130.0,681,340196
406,,,160.0,732,340928
407,,,260.0,1057,341985
408,,,380.0,1224,343209
409,,,100.0,704,343913
410,,,155.0,663,344576
411,,,195.0,962,345538
412,,,220.0,851,346389
413,,,725.0,1718,348107
414,,,120.0,717,348824
415,,,190.0,794,349618
416,,,145.0,938,350556
417,,,20.0,389,350945
418,,,150.0,878,351823
419,,,275.0,1100,352923
420,,,515.0,952,353875
421,,,170.0,669,354544
422,,,220.0,1405,355949
423,,,205.0,1163,357112
424,,,140.0,715,357827
425,,,580.0,1248,359075
426,,,700.0,1622,360697
427,,,100.0,618,361315
428,,,70.0,684,361999
429,,,260.0,866,362865
430,,,275.0,1557,364422
431,,,125.0,589,365011
432,,,450.0,1131,366142
433,,,205.0,703,366845
434,,,105.0,481,367326
435,,,90.0,620,367946
436,,,160.0,694,368640
437,,,50.0,636,369276
438,,,50.0,387,369663
439,,,75.0,540,370203
440,,,180.0,822,371025
441,,,230.0,930,371955
442,,,150.0,855,372810
443,,,625.0,1241,374051
444,,,170.0,553,374604
445,,,165.0,1077,375681
446,,,255.0,885,376566
447,,,115.0,478,377044
448,,,365.0,974,378018
449,,,410.0,879,378897
450,,,230.0,653,379550
451,,,180.0,629,380179
452,,,115.0,781,380960
453,,,225.0,1004,381964
454,,,25.0,366,382330
455,,,105.0,642,382972
456,,,130.0,650,383622
457,,,190.0,685,384307
458,,,185.0,1119,385426
459,,,400.0,1410,386836
460,,,165.0,1053,387889
461,,,130.0,648,388537
462,,,135.0,657,389194
463,,,55.0,478,389672
464,,,110.0,480,390152
465,,,170.0,685,390837
466,,,495.0,1013,391850
467,,,150.0,901,392751
468,,,135.0,697,393448
469,,,370.0,1206,394654
470,,,25.0,510,395164
471,,,70.0,566,395730
472,,,160.0,645,396375
473,,,40.0,500,396875
474,,,335.0,940,397815
475,,,35.0,515,398330
476,,,425.0,1398,399728
477,,,145.0,634,400362
478,,,40.0,509,400871
479,,,180.0,952,401823
480,,,95.0,650,402473
481,,,150.0,622,403095
482,,,350.0,780,403875
483,,,45.0,643,404518
484,,,70.0,686,405204
485,,,265.0,1052,406256
486,,,455.0,1621,407877
487,,,5.0,381,408258
488,,,320.0,1244,409502
489,,,355.0,1279,410781
490,,,415.0,1486,412267
491,,,195.0,851,413118
492,,,165.0,781,413899
493,,,265.0,1193,415092
494,,,155.0,635,415727
495,,,265.0,1298,417025
496,,,90.0,555,417580
497,,,375.0,836,418416
498,,,145.0,701,419117
499,,,150.0,694,419811
500,,,215.0,907,420718
501,,,340.0,921,421639
502,,,285.0,976,422615
503,,,210.0,800,423415
504,,,165.0,1343,424758
505,,,275.0,1026,425784
506,,,165.0,667,426451
507,,,135.0,888,427339
508,,,140.0,628,427967
509,,,330.0,1203,429170
510,,,350.0,1432,430602
511,,,105.0,718,431320
512,,,100.0,618,431938
513,,,530.0,1322,433260
514,,,290.0,992,434252
515,,,440.0,922,435174
516,,,75.0,354,435528
517,,,325.0,948,436476
518,,,110.0,527,437003
519,,,360.0,917,437920
520,,,160.0,819,438739
521,,,75.0,672,439411
522,,,100.0,566,439977
523,,,135.0,695,440672
524,,,250.0,1161,441833
525,,,70.0,792,442625
526,,,195.0,723,443348
527,,,135.0,766,444114
528,,,220.0,999,445113
529,,,35.0,399,445512
530,,,230.0,867,446379
531,,,235.0,1016,447395
532,,,155.0,955,448350
533,,,125.0,540,448890
534,,,60.0,626,449516
535,,,285.0,994,450510
536,,,70.0,334,450844
537,,,170.0,1113,451957
538,,,200.0,842,452799
539,,,110.0,904,453703
540,,,360.0,1326,455029
541,,,120.0,538,455567
542,,,170.0,793,456360
543,,,160.0,638,456998
544,,,190.0,669,457667
545,,,120.0,537,458204
546,,,380.0,1223,459427
547,,,230.0,1362,460789
548,,,240.0,1112,461901
549,,,295.0,878,462779
550,,,335.0,1108,463887
551,,,110.0,601,464488
552,,,315.0,951,465439
553,,,120.0,507,465946
554,,,225.0,703,466649
555,,,115.0,662,467311
556,,,60.0,357,467668
557,,,180.0,623,468291
558,,,175.0,693,468984
559,,,210.0,963,469947
560,,,310.0,908,470855
561,,,225.0,1127,471982
562,,,305.0,1010,472992
563,,,90.0,626,473618
564,,,85.0,714,474332
565,,,120.0,483,474815
566,,,25.0,396,475211
567,,,245.0,1083,476294
568,,,150.0,860,477154
569,,,135.0,839,477993
570,,,265.0,954,478947
571,,,335.0,646,479593
572,,,285.0,1013,480606
573,,,105.0,554,481160
574,,,350.0,1047,482207
575,,,675.0,1456,483663
576,,,110.0,699,484362
577,,,380.0,980,485342
578,,,90.0,692,486034
579,,,100.0,589,486623
580,,,80.0,393,487016
581,,,410.0,1454,488470
582,,,105.0,398,488868
583,,,95.0,685,489553
584,,,55.0,698,490251
585,,,225.0,1157,491408
586,,,175.0,932,492340
587,,,80.0,652,492992
588,,,35.0,350,493342
589,,,330.0,1139,494481
590,,,35.0,932,495413
591,,,280.0,903,496316
592,,,195.0,691,497007
593,,,355.0,1168,498175
594,,,315.0,904,499079
595,,,120.0,762,499841
